EMOAResults: 
n_generated: 1952
n_expanded: 1493
n_domCheck: 0
rt_initHeu: 0
rt_search: 0.033
timeout: 0
num_nondom_labels_max: -1
num_nondom_labels_avg: -1
N: 82
Label: 5285
[140.000000,109.000000,100.000000,]
1 14 15 28 41 54 55 68 81 82 95 108 109 110 111 124 125 126 127 128 129 142 143 156 169 
Label: 5070
[123.000000,117.000000,90.000000,]
1 14 15 28 41 54 55 68 69 82 95 108 109 110 123 136 137 150 151 164 165 166 167 168 169 
Label: 4962
[120.000000,136.000000,71.000000,]
1 14 15 28 41 54 55 68 69 82 95 108 109 110 111 124 137 150 151 152 153 154 167 168 169 
Label: 4862
[118.000000,119.000000,88.000000,]
1 14 15 28 41 54 55 68 69 82 95 108 109 110 111 124 137 138 139 140 141 142 143 156 169 
Label: 5195
[131.000000,99.000000,113.000000,]
1 14 15 28 41 54 55 68 69 70 71 84 85 86 87 88 89 102 103 116 129 142 143 156 169 
Label: 4814
[117.000000,111.000000,95.000000,]
1 14 15 28 41 54 55 68 81 94 107 120 133 134 135 136 137 150 151 164 165 166 167 168 169 
Label: 4696
[116.000000,77.000000,125.000000,]
1 14 15 16 17 18 19 20 21 22 35 36 49 50 63 76 77 90 103 116 129 142 143 156 169 
Label: 4586
[114.000000,128.000000,79.000000,]
1 14 15 28 41 54 55 68 69 82 95 108 109 110 111 124 137 138 139 152 153 154 155 156 169 
Label: 4538
[114.000000,81.000000,122.000000,]
1 2 3 4 5 18 19 20 21 22 35 36 49 50 63 76 77 90 103 116 129 142 143 156 169 
Label: 4403
[111.000000,124.000000,83.000000,]
1 14 15 28 41 54 55 68 69 82 95 108 109 110 111 124 137 138 151 164 165 166 167 168 169 
Label: 5029
[122.000000,114.000000,94.000000,]
1 14 15 28 41 54 55 68 81 94 107 108 109 110 111 124 137 150 151 164 165 166 167 168 169 
Label: 4394
[111.000000,121.000000,84.000000,]
1 14 15 28 41 54 55 68 69 82 95 108 109 110 111 124 137 138 139 152 165 166 167 168 169 
Label: 4360
[111.000000,106.000000,108.000000,]
1 14 15 16 17 18 31 44 45 46 59 60 61 62 63 76 77 90 103 116 129 142 143 156 169 
Label: 4303
[111.000000,81.000000,126.000000,]
1 2 3 16 17 18 19 20 21 22 35 36 49 50 63 76 77 90 103 116 129 142 143 156 169 
Label: 2018
[94.000000,127.000000,106.000000,]
1 2 3 4 17 18 31 44 45 58 71 84 85 98 111 124 137 138 139 140 141 142 143 156 169 
Label: 5044
[122.000000,120.000000,80.000000,]
1 14 15 28 41 54 55 68 69 82 95 108 109 110 111 124 137 150 151 164 165 166 167 168 169 
Label: 3139
[102.000000,82.000000,127.000000,]
1 2 3 4 17 18 19 20 21 22 35 48 49 50 63 76 89 90 103 116 129 142 143 156 169 
Label: 1929
[94.000000,88.000000,121.000000,]
1 14 15 16 17 18 31 44 45 46 47 48 49 50 63 76 77 90 103 116 129 142 143 156 169 
Label: 1044
[87.000000,96.000000,118.000000,]
1 2 3 4 17 18 31 32 45 46 47 48 49 50 63 76 77 90 103 116 129 142 143 156 169 
Label: 1878
[93.000000,152.000000,87.000000,]
1 2 3 4 17 18 31 44 45 46 59 72 85 98 111 124 137 150 151 152 153 154 167 168 169 
Label: 1111
[87.000000,129.000000,102.000000,]
1 2 3 4 17 18 31 44 45 58 71 84 85 98 111 124 137 138 139 152 165 166 167 168 169 
Label: 1651
[92.000000,92.000000,118.000000,]
1 2 3 4 5 18 31 44 45 46 47 48 49 50 63 76 77 90 103 116 129 142 143 156 169 
Label: 1150
[87.000000,145.000000,88.000000,]
1 2 3 4 17 18 31 44 57 58 71 84 85 98 111 124 137 138 139 152 153 154 167 168 169 
Label: 5057
[123.000000,107.000000,105.000000,]
1 14 15 28 41 54 55 68 81 94 107 120 133 134 135 136 149 150 151 164 165 166 167 168 169 
Label: 4041
[109.000000,71.000000,133.000000,]
1 14 15 16 17 18 19 20 21 22 35 48 49 50 63 76 77 90 103 116 129 142 143 156 169 
Label: 1451
[90.000000,134.000000,99.000000,]
1 2 3 4 17 18 31 44 57 58 71 84 85 98 111 124 137 138 139 152 165 166 167 168 169 
Label: 507
[81.000000,100.000000,110.000000,]
1 2 3 4 17 18 31 44 45 46 47 48 49 50 63 76 77 90 103 116 129 142 143 156 169 
Label: 3728
[106.000000,112.000000,99.000000,]
1 14 15 28 41 54 55 68 81 94 107 120 133 134 135 136 137 138 139 152 165 166 167 168 169 
Label: 83
[74.000000,140.000000,126.000000,]
1 2 3 4 17 18 31 44 45 58 59 72 85 86 87 100 113 126 139 152 153 154 167 168 169 
Label: 1074
[87.000000,99.000000,115.000000,]
1 2 3 4 17 18 31 44 45 46 47 48 49 50 63 76 89 90 103 116 129 142 143 156 169 
Label: 3741
[106.000000,115.000000,98.000000,]
1 14 15 28 41 54 55 68 81 94 107 120 133 134 135 136 137 138 151 164 165 166 167 168 169 
Label: 4476
[113.000000,110.000000,103.000000,]
1 14 15 28 41 54 55 68 81 94 107 120 133 134 135 136 137 138 139 140 141 142 143 156 169 
Label: 158
[76.000000,142.000000,103.000000,]
1 2 3 4 17 18 31 44 45 58 59 72 85 98 111 124 137 138 139 152 153 154 167 168 169 
Label: 1102
[87.000000,124.000000,109.000000,]
1 2 3 4 17 18 31 44 45 46 47 48 49 50 63 76 77 90 103 116 129 142 143 156 155 168 169 
Label: 219
[77.000000,129.000000,137.000000,]
1 2 3 4 17 18 31 44 45 58 59 72 85 86 87 100 113 126 139 152 165 166 167 168 169 
Label: 1399
[90.000000,114.000000,109.000000,]
1 2 3 4 17 18 31 44 45 46 47 48 49 62 63 76 77 90 103 116 129 142 143 156 169 
Label: 1458
[90.000000,136.000000,97.000000,]
1 2 3 4 17 18 31 44 45 58 71 84 85 98 111 124 137 138 139 152 153 154 155 156 169 
Label: 809
[84.000000,140.000000,91.000000,]
1 2 3 4 17 18 31 44 45 58 71 84 85 98 111 124 137 138 139 152 153 154 167 168 169 
Label: 329
[79.000000,131.000000,114.000000,]
1 2 3 4 17 18 31 44 45 58 59 72 85 98 111 124 137 138 139 152 165 166 167 168 169 
Label: 5220
[133.000000,105.000000,109.000000,]
1 14 15 28 41 54 55 68 81 94 107 120 133 134 135 136 149 162 163 164 165 166 167 168 169 
Label: 1537
[91.000000,90.000000,132.000000,]
1 2 3 4 17 18 31 32 33 34 35 48 49 50 63 76 77 90 103 116 129 142 143 156 169 
Label: 350
[79.000000,134.000000,113.000000,]
1 2 3 4 17 18 31 44 45 58 59 72 85 98 111 124 137 138 151 164 165 166 167 168 169 
Label: 4914
[119.000000,117.000000,93.000000,]
1 14 15 28 41 54 55 68 69 82 95 108 109 110 111 124 125 126 139 152 165 166 167 168 169 
Label: 1993
[94.000000,117.000000,108.000000,]
1 2 3 4 17 18 31 44 45 46 47 48 61 62 63 76 77 90 103 116 129 142 143 156 169 
Label: 688
[82.000000,143.000000,101.000000,]
1 2 3 4 17 18 31 44 45 58 71 72 85 98 111 124 137 138 139 152 153 154 167 168 169 
Label: 559
[81.000000,148.000000,89.000000,]
1 2 3 4 17 18 31 44 45 46 59 72 85 98 111 124 137 138 139 152 153 154 167 168 169 
Label: 2152
[95.000000,136.000000,96.000000,]
1 2 3 4 17 18 31 44 45 46 59 72 85 98 111 124 137 150 151 164 165 166 167 168 169 
Label: 2683
[99.000000,82.000000,144.000000,]
1 2 3 16 17 18 31 32 33 34 35 48 49 50 63 76 77 90 103 116 129 142 143 156 169 
Label: 3804
[107.000000,75.000000,130.000000,]
1 2 3 4 5 18 19 20 21 22 35 48 49 50 63 76 77 90 103 116 129 142 143 156 169 
Label: 3582
[104.000000,117.000000,102.000000,]
1 2 3 4 17 18 31 44 45 46 59 60 61 62 63 76 89 90 103 116 129 142 143 156 169 
Label: 1296
[89.000000,92.000000,122.000000,]
1 2 3 16 17 18 31 44 45 46 47 48 49 50 63 76 77 90 103 116 129 142 143 156 169 
Label: 368
[79.000000,147.000000,100.000000,]
1 2 3 4 17 18 31 44 57 58 59 72 85 98 111 124 137 138 139 152 153 154 167 168 169 
Label: 803
[84.000000,137.000000,100.000000,]
1 2 3 4 17 18 31 44 45 46 59 72 85 98 111 124 137 138 139 152 165 166 167 168 169 
Label: 5267
[138.000000,111.000000,90.000000,]
1 14 15 28 41 54 55 68 69 82 95 108 109 110 111 124 125 126 127 128 129 142 143 156 169 
Label: 2219
[96.000000,83.000000,122.000000,]
1 2 3 4 17 18 19 20 21 22 35 48 49 50 63 76 77 90 103 116 129 142 143 156 169 
Label: 2143
[95.000000,132.000000,99.000000,]
1 2 3 4 5 18 31 44 45 58 71 84 85 98 111 124 137 138 139 152 153 154 167 168 169 
Label: 2380
[96.000000,136.000000,89.000000,]
1 14 15 28 41 54 55 56 57 58 71 84 85 98 111 124 137 138 139 152 153 154 167 168 169 
Label: 2472
[97.000000,128.000000,102.000000,]
1 14 15 16 17 18 31 44 45 58 71 84 85 98 111 124 137 138 139 152 153 154 167 168 169 
Label: 4128
[109.000000,110.000000,105.000000,]
1 2 3 4 5 18 31 44 45 46 59 60 61 62 63 76 77 90 103 116 129 142 143 156 169 
Label: 3239
[102.000000,137.000000,78.000000,]
1 14 15 28 41 54 55 68 69 82 95 96 109 110 111 124 137 138 139 152 153 154 167 168 169 
Label: 3298
[103.000000,89.000000,114.000000,]
1 2 3 4 17 18 19 20 21 22 35 36 49 50 63 76 77 90 103 116 129 142 143 156 169 
Label: 2613
[98.000000,118.000000,97.000000,]
1 2 3 4 17 18 31 44 45 46 59 60 61 62 63 76 77 90 103 116 129 142 143 156 169 
Label: 2741
[99.000000,98.000000,115.000000,]
1 2 3 4 17 18 19 20 33 34 47 48 49 50 63 76 77 90 103 116 129 142 143 156 169 
Label: 3449
[104.000000,75.000000,134.000000,]
1 2 3 16 17 18 19 20 21 22 35 48 49 50 63 76 77 90 103 116 129 142 143 156 169 
Label: 2811
[99.000000,149.000000,86.000000,]
1 2 3 4 17 18 31 44 57 58 71 84 85 98 111 124 137 150 151 152 153 154 167 168 169 
Label: 2955
[100.000000,135.000000,94.000000,]
1 14 15 28 41 54 55 68 81 94 107 120 133 134 147 148 149 150 151 152 153 154 167 168 169 
Label: 4616
[115.000000,70.000000,138.000000,]
1 14 15 16 17 18 19 20 21 22 35 48 49 50 63 76 89 90 103 116 129 142 143 156 169 
Label: 2965
[100.000000,142.000000,83.000000,]
1 2 15 28 41 54 55 68 69 82 95 96 109 110 111 124 137 138 139 152 153 154 167 168 169 
Label: 2561
[98.000000,110.000000,108.000000,]
1 2 3 4 17 18 31 44 45 46 47 48 35 36 49 50 63 76 77 90 103 116 129 142 143 156 169 
Label: 3069
[101.000000,128.000000,93.000000,]
1 2 15 28 41 54 55 68 81 94 107 120 133 134 135 136 137 138 139 152 153 154 167 168 169 
Label: 3386
[103.000000,123.000000,88.000000,]
1 14 15 28 41 54 55 68 81 94 107 120 133 134 135 136 137 138 139 152 153 154 167 168 169 
Label: 5246
[138.000000,105.000000,104.000000,]
1 14 15 28 41 54 55 68 81 94 107 108 109 110 111 124 125 126 127 128 129 142 143 156 169 
Label: 674
[82.000000,138.000000,109.000000,]
1 2 3 4 17 18 31 44 45 58 59 72 85 98 111 124 137 138 139 152 153 154 155 156 169 
Label: 3976
[108.000000,126.000000,87.000000,]
1 14 15 28 41 54 55 68 81 94 107 108 109 110 111 124 137 138 139 152 153 154 167 168 169 
Label: 4426
[112.000000,118.000000,94.000000,]
1 14 15 28 41 54 55 68 69 82 95 108 109 110 123 136 137 138 139 152 165 166 167 168 169 
Label: 3537
[104.000000,114.000000,105.000000,]
1 2 3 4 17 18 31 32 45 46 59 60 61 62 63 76 77 90 103 116 129 142 143 156 169 
Label: 3653
[105.000000,108.000000,109.000000,]
1 14 15 28 41 54 55 56 57 58 59 60 61 62 63 76 77 90 103 116 129 142 143 156 169 
Label: 3986
[108.000000,132.000000,73.000000,]
1 14 15 28 41 54 55 68 69 82 95 108 109 110 111 124 137 138 139 152 153 154 167 168 169 
Label: 4079
[109.000000,88.000000,119.000000,]
1 2 3 4 17 18 19 20 21 22 35 36 49 50 63 76 89 90 103 116 129 142 143 156 169 
Label: 4162
[109.000000,119.000000,94.000000,]
1 14 15 28 41 54 55 68 81 94 107 120 133 134 135 136 137 138 139 152 153 154 155 156 169 
Label: 1132
[87.000000,132.000000,101.000000,]
1 2 3 4 17 18 31 44 45 58 71 84 85 98 111 124 137 138 151 164 165 166 167 168 169 
Label: 4180
[109.000000,129.000000,83.000000,]
1 14 15 28 41 54 55 68 69 82 95 108 109 110 123 136 137 138 139 152 153 154 167 168 169 
